1111111111111
1001000E000C1
1000011111001
10010000000C1
1P0011E00M001
10010000000C1
1111111111111